R 5000 5000
NO ./images/greystone.xpm
SO ./images/colorstone.xpm
EA ./images/colorstone.xpm
WE ./images/bluestone.xpm
S ./images/barrel.xpm
F 220,200,0
C 225,230,0
11111
10001
10E01
10001
11111