R 5000 5000
NO ./images/greystone.xpm
SO ./images/colorstone.xpm
EA ./images/colorstone.xpm
WE ./images/bluestone.xpm
S ./images/barrel.xpm
F 220,200,0
C 225,230,0
11111111111
100000E0001
10000000001
11111111111