R 1280 720
NO ./images/greystone.xpm
SO ./images/colorstone.xpm
EA ./images/flower.xpm
WE ./images/bluestone.xpm
S ./images/barrel.xpm
F 164,202,104
C 137,189,222
1111111111111111
1000000000000001
1010000000001101
1010000000000001
1010000E00001101
1000000000000001
1010101010001101
1000000000000001
1111111111111111