
R 800 800
NO ./textures/wood.xpm
SO ./textures/grey.xpm
WE ./textures/wall.xpm
EA ./textures/blue.xpm

S ./textures/barrel.xpm
F 153,51,102
C 120,120,120


          1111111111111111111111111
          1000000000110000100000001
          1011000001110000102000001
          1001000000000000100000001
  111111111011000001110000100000001
  100000000011000001111111110111111
  11110111111111011100000010001
  11110111111111011101210010001
  11000000110101011100000010001
  10002000000000001100000000001
  10000000000000001121210010001
  1100000111010101111101111N00111
  111101111 110101 101111010001
  111111111 111111 111111111111
