R 1024 576 
NO ./images/kohh.xpm
SO ./images/eminem.xpm
EA ./images/gaki_ranger.xpm
WE ./images/zorn.xpm
S ./images/barrel.xpm
F 164,202,104
C 137,189,222
1111111111111111111111
1000000000000000000001
1000000000000000000001
1000000000000000000001
1000000000000000000001
1000000000000000000001
1000000000N00000000201
1000000000000002020001
1000000000000000000001
1111111111111111111111