R 1023 576

NO ./images/kohh.xpm

SO ./images/eminem.xpm

EA ./images/gaki_ranger.xpm

WE ./images/zorn.xpm

S ./images/pillar.xpm

F 164,202,104

C 137,189,222

01111111111111
100000220000001
1020E0220000001
100000220000001
 11111111111110
