R 1024 576
NO ./images/kohh.xpm
SO ./images/eminem.xpm
EA ./images/gaki_ranger.xpm
WE ./images/zorn.xpm
S ./images/pillar.xpm
F 164,202,104
C 137,189,222
1111111111111111111111
1000000000000000000001
1000000000000000000001
10000000000000S0000001
1000000000000000000001
1000000000000010010101
1000000000000000000201
1000000000000002210001
1000000000000002000001
1111111111111111111111