R 1024 576

NO ./images/kohh.xpm

SO ./images/eminem.xpm

EA ./images/gaki_ranger.xpm

WE ./images/zorn.xpm

S ./images/pillar.xpm

F 164,202,104

C 137,189,222

11111
10201
10001
10N01
11111
