R 900 600
NO ./images/kohh.xpm
SO ./images/eminem.xpm
EA ./images/gaki_ranger.xpm
WE ./images/zorn.xpm
S ./images/pillar.xpm
F 164,202,104
C 137,189,222
 1111111111 111111111
1222222222212222222221
1222222222222222222221
12222222222222E2222221
1222222222222222222221
 10000000000000001001
1000000000020202020201
1000000000000202100201
1000000000010000000001
 1111111111 111111111