R 600 400

NO ./textures/greystone.xpm
SO ./textures/colorstone.xpm
EA ./textures/colorstone.xpm
WE ./textures/bluestone.xpm
S ./textures/barrel.xpm


F 220,200,0
C 225,230,0
000000000000000000000000000000000
100000000011000001110111111111111
11110111111111011100000010000001
11110111111111011101010000E20201
11000000110101011100000010002001
10000000000000011000000110020201
10000000000000001101010010002001
11000001110101011111011110000001
11110111 1110101 101111010000001
11111111 1111111 111111111111111
