R 600 400

NO ./textures/greystone.xpm
SO ./textures/colorstone.xpm
EA ./textures/colorstone.xpm
WE ./textures/bluestone.xpm
S ./textures/barrel.xpm


F 220,200,0
C 225,230,0

100010000011000001110111111111111
11110111111111011100000010000001
11110111111111011101010010E20201
11000000110101011100000010002001
10000000000000000000000110020201
100000000000000011010100000020011
0011000001110101011111011110000001
11110111 1110101 1011110100000011
11111111 1111111 111111111111111
