R 1920 1080

NO ./images/north.xpm

SO ./images/north.xpm

EA ./images/north.xpm

WE ./images/north.xpm

S ./images/barrel.xpm

C 200,50,100

F 50,100,200

111111111
102000201
120000021
1000N0001
120000021
102000201
111111111
