
R 1280 576

SO ./images/zorn.xpm

NO ./images/wavy.xpm

EA ./images/kohh.xpm

WE ./images/eminem.xpm

S ./images/barrel.xpm

C 0,0,0

F 255,255,255

111111111111111111111111111111111111111111111111
122222222222222222222222222222222222222222222221
122222222222222222222222222222222222222222222221
122222222222222222222222222222222222222222222221
122222222222222222222222222222222222222222222221
122222222222222222222222222222222222222222222221
122222222222222222222222222222222222222222222221
122222222222222222222222222222222222222222222221
122222222222222222222222222222222222222222222221
122222222222222222222222222222222222222222222221
122222222222222222222222222222222222222222222221
122222222222222222222222222222222222222222222221
122222222222222222222222222222222222222222222221
122222222222222222222222222222222222222222222221
122222222222222222222222222222222222222222222221
122222222222222222222222222222222222222222222221
122222222222222222222222222222222222222222222221
122222222222222222222222222222222222222222222221
122222222222222222222222222222222222222222222221
122222222222222222222222222222222222222222222221
122222222222222222222222222222222222222222222221
122222222222222222222222222222222222222222222221
122222222222222222222222222222222222222222222221
122222222222222222222222222222222222222222222221
122222222222222222222222222222222222222222222221
122222222222222222222222222222222222222222222221
122222222222222222222222222222222222222222222221
122222222222222222222222222222222222222222222221
122222222222222222222222222222222222222222222221
122222222222222222222222222222222222222222222221
122222222222222222222222222222222222222222222221
122222222222222222222222222222222222222222222221
122222222222222222222222222222222222222222222221
122222222222222222222222222222222222222222222221
122222222222222222222222222222222222222222222221
122222222222222222222222222222222222222222222221
122222222222222222222222222222222222222222222221
122222222222222222222222222222222222222222222221
122222222222222222222222N22222222222222222222221
122222222222222222222222222222222222222222222221
111111111111111111111111111111111111111111111111